111111111111111111111
110101010010001010101
100101011001101000001
110101011100001111101
110101011111100001001
100000011111111100011
101111000111111101111
101110010000000000001
101111111111101011101
111111111111101001101
101000011110001101101
200011000000101101101
111111111011101101101
100111111010000111103
110111100010111111101
110111101010111111101
110111101010011110001
110111101011001110101
110000001011101110101
100101101000101000101
111111111111111111111
