111111111111111111111
101000000000000000101
201011011111011101101
100001010011000100001
110101010111110111101
110101000100010001101
110101110001011111101
110101110111000001101
110101111111111111111
110111111110001110001
110110011110100000111
110000110000101111101
100110110110111100001
101111110110111101111
100000000110111101001
101011010111111101011
101111010011111000011
101110011000000011011
101110111111111011011
101000000000011010001
111111111113111111111
