111111111111111111111
100001100000000100001
101110001110110001101
100010111000100101101
101000110010101111101
101111000110100011001
101110011000101111011
100110111011101110001
111100111011001000101
100001111010010011101
101111111110110111101
101111111110010001101
101111110001010100101
101111110101011110011
101111110100011111011
101111110111100001011
201111110100001100001
100111110101111111111
110001000101110001001
100101010100000100011
111111111111111111311
