111111111112111111111
100100010000100010001
110001000101101010101
111111111101101010101
100000000101001000101
101000000100011111101
100000000111011111101
101000000110000000011
101000000110000000011
101000000110000000011
101000000110000000011
101000000110000000011
101111111111111111011
100001000000001111011
101101000000001000011
101001000000000011101
101011000000001011101
101011000000001001001
101001000000001100011
101101011111100011001
111111111111111111131
