111111111112111111111
111111111100011100011
111000000011000001101
111000000010011101101
111000000000111101101
111000000010001101101
111000000011111100001
111000000011111101101
111000000011111111101
111111111111111111101
111111111000000000101
111111111000000000101
111111111000000000101
111111111000000000101
111111111000000000101
111111111000000000101
111111111000000000101
111111111000000000101
111111111000000000001
111111111000000000101
111111111111111111131
