111111111111111111121
101000100001000000001
101010001100111110101
101011011110000100101
100011000111110001101
111100010001000101101
100001011101110111101
110101001101110110003
100111111100011110111
101110001111011110101
100000100011011110001
101110101110011111101
100010100100111000101
111010010101111010101
101011010100011010011
100011010111011011011
101100010011011110001
101001111111001110101
101011000000100100101
101000011110110001101
111111111111111111111
