111111111111111112111
111110000001000000001
111110000001011010101
111110000001010000101
111110000001010000101
111111011111010000101
110000011111010000103
110000011111010000101
110000011111011111101
110000011111001111101
101111011111111111101
101000011111000011101
101000011111000011101
101000011111000011101
101000011111000011001
100011111111000011011
110111110001000011001
110111100101110111011
110000001100000111011
100111010001010000001
111111111111111111111
