111111111111111111111
100010000000000000011
101110110000001111003
100110010000001011101
110111010000001011111
100011000000001000001
101000010000001000001
111111011111111000001
100001011111111000001
200001001000011000001
100001100011011001111
100000111100001011101
100000000100001111101
101110000100001110001
100010000100001100111
101010000100001001001
101010000111111011011
101011011000110011001
101010001010110111101
101000100010010000001
111111111111111111111
