111111111111111111111
100101000000111101001
110101010111110001011
110101010111110110001
110000010000000000111
100111010111111110001
110111110111000011011
110111110000011011001
111110000110111011101
101100111110000111101
101101100110110011101
100000001100110111101
101111101101110111101
101111101101110001101
101111101000011111101
101111001011011111111
100001111011000000001
101101111011011111011
101100011111011111011
200011000100000100001
111111111111111113111
