111111111111111111111
201111000001000000001
100000011100011111111
110000011110111000001
110000011000011000001
110000011000011000011
100000011000011000011
101110111000011000001
101000011111111101111
101000011111000000001
101000011111110000011
101000011111110000011
101010111111110000011
101000000001110000001
101111101111111111101
101000001000001011101
101000000000001011101
101000001000001011001
101000001000001010011
101011101011101000111
131111111111111111111
