111111111111111111211
111111111100001000001
111111111100001111101
111000000100001111101
111000000100001111101
111000000111001111101
111000000111100000101
111000000111100000101
111000000111100000101
111101011111100000101
110000011111101111103
110000011000000111101
110000011000000111101
110000011000000111101
110000011000000110001
110000011111111100101
111111111111110001111
100000000111000111001
111110111111010110011
100000000000010000111
111111111111111111111
