111111111111111111111
100010000000110001001
101000111010000100011
101110011011111111011
101111011000001111003
100011001111100001111
101111101000111100001
101111101010011111101
101000100011011000101
200010111111111010101
101110000000110010111
101111111110000110001
100000000011110100101
101111111111000101101
100100000011011101101
110101111001111111101
100101111101100001101
101100111101101101101
101110011100101000101
100001000010001010001
111111111111111111111
