1111111111121111111111111111111111111111111111111111111111111111111111111111111111111111111111111
1000000011000000100011100010000000000110000010001110000000100001000001100001000001101000101010101
1010111000010111001000001100110110111000111000100000101110001100010110001100011100100010100010001
1010111111110110011101100001110011111010001111110111101110100111110110100111011110001010001011011
1011100000110100111101101100111001100011111100010110000110110000111100111111001110101010111001001
1011101010111101111101000110000101001100001101000110110110011110011001100011100011101010111101101
1001001010011101111101011111110100011101100001011100011111011111000011101000111111001010011100001
1100010011010001001101011000011111110001001111010001111011001000111011101110011110011011011111111
1101010111000100011101110011011000010111010000010111110011101010001001100011011000110001001100001
1001010111010111001100110111011011000111010110110000000110001011101100111011000010010101111001101
1011010001010111100110110110011001111000010010110111111100101011101111111000111111011100001010001
1011010111010011110011110110111101000011011010010100010001101001111000011110001111001111100010111
1011110111011011111011000010001101011100011011010001010111101101110011000001100001100011111010011
1001110100001010110011011111111001011101011011001101010001101100110111011101001101101011111011001
1100011101101000110110001111110011001101001111101101011100111110100011011101011101111001000011101
1011001101111011110010101000100111101101101110001001000010001110001110010001001100111101011110001
1011101111111000011010100010001011001001101100101011011010100111111100110101111110000101110000101
1011101111000111111010111111111011011011101101111011110010110000111101110100011000110101100111101
1011101000010111100010000011100010001001111000110011100110011110011101110111111011100111001100001
1001101011110000101110111000101110101101110010010111001111000111000100110001110011001111011101011
1101101000011110100010111010000100101101000111010011011000010000110101111101000111010000011101011
1000101011011000111010111111110101111001011111011111011011110110110100011001011111110111111101003
1010001011001010100010011111111100111011011100010001011000110110110111110011000011110100000111101
1011111001101011101111111000001110010001000101100100010010111110100001100110011011111101110111001
1000011111101011101000110011100111010101110101001111110110001100101101101110100001111111100100011
1011110000001000001010100111110100010111000111011100010001011001101001101000101100000111001101001
1011000111101111110010001110000001110011011111000101011101011011111011101011100011110100011101111
1111010000101100000110101111111111111011001111110101000101011011110010001001001000110101111100011
1000011110100101110110100111110001111001101111110101110001011000010110111101011101110100011111001
1011111110110100010110110000111101111101000101100101111111001111010000111001011101000101011111101
1011111110110101010110011110011101111111010101101100010000100011011111111011111101011111000011001
1001100011100111010011000111000101111111010000100011000110110111011100011011100001011111111000011
1100111011101111001011110011010001100010011110111001111100010011000001110001101111011100011011101
1110111000001001101000011011011111101010100010111100011101111011011101100101101100011111011000101
1000000111110011101111111001000011001010101010001111011101111001011111101111101101111111011010101
1111110110110111001100001100111110011010001001101111011111001101000000100001111100000001010010001
1000100010110111010001011110110000111001101101101011011111011101111110111100000011111100010110111
1010001000110010010111000011100110011101101100101011000011000001000110100011111001111101010110001
1011111110011010110000111001101111010001111110100011011011111111010010001010001101001101110001111
1001000011010010111110011100001011010110001000111110001001000010011001111110111101011100111100011
1100011001010110111111000111110011010110101011100010101101011000111100011110000101000110111111001
1001011101010000110000110000010111010011101011111000101001001011000001000001110101101110100001101
1011010001010111000110111101010000011011001001111111101011101001111101111101100101100011101100001
1011110101010111011110100001010111011001011101100000101000001101111000000100001100011011101111101
1000110111010110011110101111011111111101001101101110001011101100011011110101111001001001001111111
1110100011001110110110001100011000011101100001101110111000101111001010000111110011101100011100001
1010101011101000010111110001111011000001001111100110000110011111101010111110000111100111110001101
1010101001001011010010000111000001011101011111110111110111010011001010111100111111110000110101001
1010111101110011011000111100011101011111010111110000110011010110011010001001110000011110110111011
1010111101110111011111111001111101000111000111111110001001000100100010101011110111000110110110001
1010001100010011111000111011110001010001110011111110101101011001101110101001100000101110011110101
1011100011011011100010110010110111011101111011111111101101011010001100101101001110100011001100101
1001111001001001001010011110110011011100011001101111001001111010111101001100011000110111101001101
1101111101101100011011011110011011001111001100101100011011110010011111011101110010110011001011101
1101000000100011110001000011000011111111100110101001111011000111011111001101100111111011011011101
1100011110111000011101111011011111110000110010101011100011010011010001101001001110001010011000101
1101110000011011011100011010010011000111111010100010001001011111110100001011011110100010111010011
1000011111001001000101111010110110011000100010111110111101010001110101111011000110111010001011011
1111011111101101110111110010000110111010001010110110110001010101000111111111110010001011101001011
1000010001000100010011000111111110110010111010000110110111011100011110001100011010101011100101011
1101110101010101011010011100011100110110011011110110010011001111111100101101011010101001110111001
1101100101010111001000111001001001100111111001111111011001100001110001100111011010100101110011101
1001101101010011101111111011100011001100000111000010000100011100000111110111011010110100111000101
1011101100011001100000011000111100011001110100011000110111011111110100010010011010100101100010001
1011100101111101101111000110110001110010110101011111110111000000111101011000110011101100101110111
1001110100001101101111110010110111110110110001011100010000111110011001011011000111101110100011101
1101100110111001001100011010000100010010001111011101011110000011001011011110010110000110011011001
1011101110110011011001000010111101011000100001001101000010111011101001011110110110110111011000011
1010001111110111001011111110110001011111111100100001111010011000101101111000010010110111001111101
1000111111100111101010000001110101010001000110111111000011011110100101100011011010010001101000101
1101111111101111111010111100100101000101010110001000011111111111110100101001010011001101100010001
1101100010001111111010111110001101011100011111101011011011000111100110101101010111100111111111011
1101001010101000001000100000101101000011011001101001110011010011001110101101010000010111110011001
1001011010101110101111101111111101111011011011101101100111011011010000101001011111010000110111101
1011011010111110100010000110000100001010011000001101101111011011010111101011001011010110110100001
1000111010110000101010110010110011101010111011111100101100001000010111101000100011010110110001101
1110000010100111101010011010111011001010001010000110001001101011100100001110101111010100111111101
1011111110101110001001001110110011011001101110110011101011101001101101111110100011011101000011001
1000000000101110111101100110110111011101001100001001111000100111000100001111111011001101011110011
1111111110100110110001110010110010001101011001101100011110110011010101100111110001100101000110111
1000000011110110110111111010011000111001000010001101011100111000010100110010000101111100110110111
1101111011000010110011111011000111110011011110101101011101111011110101111010111111111110100010011
1001111001011010001000111001010111100100011000111001000100001000110101100010000110000110101011001
1011011100010010101110111101010000101111100011110011010011101111100101101111101111110010101001101
1000011101110110101100100001010110101111101111000111011000100011001111001111100001111000101100101
1111110000100010111101101101011100100001101000011111011110111001011110011111101100111111100110001
1100010110101110011001001101011001101101101011111000011110001101001110100001101110010000011111111
1001011100101111110011011101001011100101101000111111100011101101111000101111101111000111011100001
1011011001101000100111011111101001110100111110111111101111101100010010100011001111111110001101101
1011110010000010101111011110001100110110011000100001101110001001010111101001010001000111100101101
1011100110111010100011110000100010010011001010101100100100101011010001111101010101010111110101001
1011001100100010111000110111111111011001101011101110110001101001011101111001010111010011000101011
1001011101111010011110010110001110011101101011111100111110001101001101100011010011011011011111011
1100010001111111001111011110100010111101001110000001000100101101101101101001011010011000011110001
1001010111000111100011011100101010111101011100111111010101101000100101001101011010111111110000101
1011010000010000011001000001101000010001000001000000010001001010110100010001000010000000000110101
1111111111111111111111111111111111111111111111111111111111111111111111111111111111111111111111111
