111111111111111111111
101000000000001000101
200010111110111101101
101110111100000000001
101111111101111111101
101111111100001111101
110000001111100111101
110000001111111111101
110000001000001110001
110000001000001100101
110000001000001101101
111101111000001000101
111100011000000010101
100001111000001110101
111101111111111100101
100101111111111101101
110000001111111101101
100111100000111101001
110110001110000001011
100110100001011101001
111111111111311111111
