111111111111211111111
111000011110001111101
110011001100100000001
100111100101101010111
101111110001001010003
101000010111010010101
100011110110010111101
111111110100110001101
101100000101111101101
101101110100001101111
100001111101101100011
101111111101100011001
101100000111111011101
111001110010000010001
100011111000111110101
101111111111110000101
101000001000000111101
101011101011110111001
101000100011100100011
101010101010001101001
111111111111111111111
