11111111111111111111111
10000010001000001000001
10111010101110101011111
10001000101000101010001
11101111101011111011101
10001000001000001000001
10111011111111101111101
10100010001000001010001
10111010101011101010111
10001010100010000010001
11101010111110111111101
10001000100010001000101
10111111101011111010101
10100000001000000010101
10101111111111111110101
10101000001000000010101
10101110101011111110101
10101000100010000000101
10101011111010111011101
10100010000010100010003
10111110111110111110111
20000000000010000000001
11111111111111111111111
