111111111111111121111
100011100000010000001
111000001111000111011
100011011111101111011
101110011100001100001
111000111111101101111
100010111111111100001
101110000110000011101
100111111110111011101
110001000100011001101
100100010111011100001
111111110111011111111
110001110001001100001
100100011101101111103
101111111001001111001
100001000011010000011
101101011111010101001
101101010000011101101
100100010111111001101
110101010000000010001
111111111111111111111
