111111111111112111111
100010000000100011011
101001111110001000001
101100000000101111111
101101111111101111001
111000111000000000011
100010111110110111011
101010111110110011001
101010111000011011101
101110100011011000101
101111101111111010101
101111100000011010101
111111001101011111101
101111010001001111111
100001010101100000001
101100010101111011101
101001011101111000101
101111011100111010101
101110000010011010101
110000111011001010101
111311111111111111111
